9 7 2 5 10 11 19 9 7 15 19 2 16 12 9 13 3 13 10 14 4 11 7 11 7 7 17 10 9 8
13 10 18 9 11 15 18 20 12 9 12 1 10 10 6 10 14 15 15 6 2 12 9 6 8 4 12 7 7 2
16 13 18 10 11 3 4 11 5 13 18 7 10 9 5 5 20 17 13 7 12 5 3 7 4 18 2 8 2 15
1 20 8 3 9 7 21 20 6 16 19 19 11 11 12 13 16 2 1 20 13 5 6 5 11 10 12 7 10 13
3 1 9 9 13 6 18 10 13 2 14 2 10 19 7 10 6 14 5 11 6 13 14 2 5 15 6 20 6 4
6 9 9 17 20 15 7 3 15 18 13 8 12 15 1 8 2 11 8 7 12 13 12 18 14 10 5 15 18 11
11 4 14 13 12 10 19 12 17 7 10 2 13 18 9 19 13 9 1 10 20 3 11 4 17 15 9 18 18 9
20 15 12 7 14 6 7 3 7 3 8 1 19 10 14 6 1 4 17 1 14 11 14 2 2 15 15 9 17 2
4 17 13 6 2 19 13 20 11 15 19 14 11 2 1 16 16 17 5 18 3 8 3 13 14 20 2 4 13 8
3 17 8 1 16 12 13 6 5 18 3 2 7 19 14 18 15 10 17 6 2 6 21 3 5 4 7 18 19 7
16 7 20 7 7 21 5 19 11 7 13 18 16 4 20 19 19 17 5 5 12 13 9 7 11 11 20 13 1 15
7 6 20 2 11 13 17 14 2 4 19 16 9 14 14 15 6 1 15 13 19 17 8 8 18 4 7 16 17 14
5 8 20 10 9 10 11 11 8 3 3 1 14 17 13 10 3 5 15 4 16 15 10 8 18 16 3 20 9 18
7 17 3 20 6 3 20 1 2 10 15 19 20 17 3 5 4 2 18 13 4 20 9 12 11 17 9 8 18 18
1 14 14 11 16 4 15 9 10 15 3 14 7 3 19 11 18 17 18 9 9 10 13 3 7 9 8 2 6 14
14 10 6 21 13 20 13 12 6 14 7 9 10 6 4 16 1 16 7 19 8 14 9 2 3 7 15 12 12 3
17 10 10 3 5 7 4 16 7 5 17 19 12 17 5 1 10 17 20 5 11 14 19 8 13 10 2 7 7 18
18 16 3 2 7 5 15 6 6 4 6 6 18 12 20 4 15 12 17 3 13 1 9 19 15 19 12 19 13 4
11 15 13 14 2 5 7 8 20 4 19 11 8 21 10 2 12 7 20 12 9 11 11 6 11 5 13 18 5 16
11 2 6 18 12 3 15 16 8 12 17 8 2 5 19 7 2 11 9 13 18 13 20 13 2 11 14 4 5 17
16 6 11 7 4 13 7 13 1 3 3 7 11 9 12 5 20 7 7 14 20 6 15 2 5 7 1 9 19 11
10 9 19 15 8 6 17 9 7 8 13 17 14 10 3 19 10 11 1 4 7 20 20 1 15 1 12 14 7 14
5 15 10 15 12 18 14 20 20 2 18 10 12 14 17 2 12 19 14 13 19 8 13 1 19 18 13 19 3 5
5 6 11 17 12 13 14 17 10 4 11 11 9 20 15 1 10 9 12 8 4 10 19 16 3 3 5 20 8 2
2 15 17 16 19 19 1 3 10 1 9 3 21 1 7 3 17 2 7 21 6 13 6 6 9 13 6 11 17 20
13 15 8 15 8 6 12 16 4 9 6 20 20 11 12 13 20 18 5 17 1 9 7 7 12 20 19 14 15 1
12 19 19 4 16 1 17 5 11 5 8 11 13 8 4 15 12 5 12 19 15 13 3 6 10 12 20 13 20 3
10 9 4 5 16 11 17 13 7 7 13 14 6 8 15 5 6 19 17 18 6 18 2 15 4 14 10 14 16 11
9 9 19 17 1 9 6 8 4 18 6 14 3 9 5 5 15 2 5 13 1 9 8 7 20 6 11 9 16 6
7 14 6 8 13 15 11 19 19 5 18 12 2 2 19 5 2 9 3 19 5 11 13 1 3 7 10 6 6 17